2 10 10 10 10 10 10 10 10 10 10 10 10 10 10 10 10 10 10 10 10 10 10 10 10 10 2 10 10 10 10 2
2 1 1 1 1 1 1 1 1 1 1 1 1 1 1 1 1 1 1 1 1 1 1 1 1 1 2 1 1 1 1 2
2 1 1 1 1 1 1 1 1 1 1 1 1 1 1 1 1 1 1 1 1 1 1 1 1 1 2 1 1 1 1 2
2 1 1 1 1 1 1 1 1 1 1 1 1 1 1 1 1 1 1 1 1 1 1 1 1 1 2 1 1 1 1 2
2 1 1 1 1 1 1 1 1 1 1 6 1 1 1 1 1 1 1 1 1 1 1 1 1 6 2 1 1 1 1 2
2 1 1 1 1 1 4 2 2 2 2 2 2 2 2 2 5 5 5 5 10 10 10 10 10 10 10 1 1 1 1 2
2 1 1 1 1 1 3 2 10 10 10 10 10 10 10 2 1 1 1 1 1 1 1 1 1 1 1 1 1 1 1 2
2 1 1 1 1 1 3 2 1 1 1 1 1 1 1 2 1 1 1 1 1 1 1 1 1 1 1 1 1 1 1 2
2 1 1 1 1 1 3 2 1 1 1 1 1 1 1 2 1 1 1 1 1 1 1 1 1 1 1 1 1 1 1 2
2 2 4 2 2 2 2 2 1 1 1 1 1 1 1 2 1 1 1 1 1 1 1 1 1 1 1 1 1 1 1 2
12 12 3 12 12 12 12 12 1 1 1 1 1 1 1 2 2 2 2 2 2 2 2 2 2 2 2 1 1 1 1 2
12 11 3 11 11 11 11 11 1 1 1 1 1 1 1 11 11 11 11 11 11 11 11 11 11 11 11 1 1 1 1 2
12 11 3 11 11 11 11 11 1 1 1 1 1 1 1 11 11 11 11 11 11 11 11 11 11 11 11 1 1 1 1 2
12 11 3 11 11 11 11 11 1 1 1 1 1 1 1 11 11 11 11 11 11 11 11 11 11 11 11 1 1 1 1 2
12 11 3 11 11 11 11 11 1 1 1 1 1 1 1 11 11 11 11 11 11 11 11 11 11 11 11 1 1 1 1 2
12 12 12 12 12 12 12 12 2 2 2 2 2 2 2 12 12 12 12 12 12 12 12 12 12 12 12 2 2 2 2 2
