19	19	19	19	19	19	19	19	19	19	43	19	19	19	19	19	19	19	19	19	19	19	19	40	19	19	19	19	19	19	19	19	19	19	19	19	19	19	19	19	19	19	19	19	19	19	19	19	19	19	41	19	19	19
19	19	19	19	19	19	19	19	19	19	43	19	19	19	19	19	19	19	19	19	19	19	19	40	19	19	19	19	19	19	19	19	19	19	19	19	19	19	19	19	19	19	19	19	19	19	19	19	19	19	41	19	19	19
19	19	19	19	19	19	19	19	19	19	43	19	19	19	19	19	19	19	19	19	19	19	19	40	36	36	36	36	36	36	36	36	36	36	36	36	36	36	36	36	36	36	36	36	36	36	36	36	36	36	41	19	19	19
19	19	19	19	19	19	19	19	19	19	43	19	19	19	19	19	19	19	19	19	19	19	19	40	90	90	90	90	90	90	90	90	90	90	90	90	90	90	90	90	90	90	90	90	90	90	90	90	90	90	41	19	19	19
19	19	19	19	19	19	19	19	19	19	43	36	36	36	36	36	36	36	36	36	36	36	36	39	90	90	90	90	90	90	90	90	90	90	90	90	90	90	90	90	90	90	90	90	90	90	90	90	90	90	41	19	19	19
19	19	19	19	19	19	19	19	19	19	43	90	90	90	90	90	90	90	90	90	90	90	90	90	90	90	90	90	90	90	90	90	90	90	90	90	90	90	90	90	90	90	90	90	90	90	90	90	90	90	41	19	19	19
19	19	19	19	19	19	19	19	19	19	43	90	90	90	90	90	90	90	90	90	90	90	90	90	90	90	90	90	90	90	90	90	90	90	90	90	90	90	90	90	90	90	90	90	90	90	90	90	90	90	41	19	19	19
19	19	19	19	19	19	19	19	19	19	43	90	90	90	90	90	90	90	90	90	90	90	90	90	90	90	90	90	90	90	90	90	68	68	90	68	68	90	90	90	90	90	90	90	90	90	90	90	90	90	41	19	19	19
19	19	19	19	19	19	19	19	19	19	43	90	90	90	90	90	90	90	90	90	90	90	90	90	90	90	90	90	90	90	68	90	90	90	90	90	90	90	68	90	90	90	90	90	90	90	90	90	90	90	41	19	19	19
19	19	19	19	19	19	19	19	19	19	43	90	90	90	90	90	90	90	90	90	90	67	68	68	68	68	68	68	68	90	90	90	90	90	90	90	90	90	90	90	68	68	68	90	90	90	90	90	90	90	41	19	19	19
19	19	19	19	19	19	19	19	19	19	43	90	90	90	90	90	90	90	90	90	90	66	90	90	90	90	90	90	90	90	90	90	90	90	90	90	90	90	90	90	90	90	90	90	90	90	90	90	90	90	41	19	19	19
19	19	19	19	19	19	19	19	19	19	43	90	90	90	90	90	90	90	90	90	90	66	90	90	90	90	90	90	90	90	90	90	90	90	90	90	90	90	90	90	90	90	90	90	90	90	90	90	90	90	41	19	19	19
19	19	19	19	19	19	19	19	19	19	43	90	90	90	90	90	90	90	90	90	90	66	90	90	90	90	90	90	90	90	90	90	90	90	90	90	90	90	90	90	90	90	90	90	90	90	90	90	90	90	41	19	19	19
19	19	19	19	19	19	19	19	19	19	43	90	90	90	90	90	90	90	90	90	90	66	90	90	90	90	90	90	90	90	90	90	90	90	90	90	90	90	90	90	90	90	90	90	90	90	90	90	90	90	41	19	19	19
19	19	19	19	19	19	19	19	19	19	43	90	90	90	90	90	90	90	90	90	90	66	90	90	90	90	90	90	90	90	14	12	12	12	12	12	12	12	12	12	12	12	12	12	12	12	12	12	12	12	13	19	19	19
19	19	19	19	19	19	19	19	19	19	18	12	12	12	12	12	12	12	12	12	12	12	12	12	12	12	12	12	12	12	13	19	19	19	19	19	19	19	19	19	19	19	19	19	19	19	19	19	19	19	19	19	19	19
19	19	19	19	19	19	19	19	19	19	19	19	19	19	19	19	19	19	19	19	19	19	19	19	19	19	19	19	19	19	19	19	19	19	19	19	19	19	19	19	19	19	19	19	19	19	19	19	19	19	19	19	19	19
19	19	19	19	19	19	19	19	19	19	19	19	19	19	19	19	19	19	19	19	19	19	19	19	19	19	19	19	19	19	19	19	19	19	19	19	19	19	19	19	19	19	19	19	19	19	19	19	19	19	19	19	19	19
19	19	19	19	19	19	19	19	19	19	19	19	19	19	19	19	19	19	19	19	19	19	19	19	19	19	19	19	19	19	19	19	19	19	19	19	19	19	19	19	19	19	19	19	19	19	19	19	19	19	19	19	19	19
19	19	19	19	19	19	19	19	19	19	19	19	19	19	19	19	19	19	19	19	19	19	19	19	19	19	19	19	19	19	19	19	19	19	19	19	19	19	19	19	19	19	19	19	19	19	19	19	19	19	19	19	19	19
